{
    "tileWidth": 16,
    "tileHeight": 16,
    "width": 10,
    "height": 8,
    "map": [
        [120, 121, 121, 121, 121, 121, 121, 121, 121, 122],
        [144, 145, 145, 145, 145, 145, 145, 145, 145, 146],
        [144, 145, 145, 145, 145, 145, 145, 145, 145, 146],
        [144, 145, 145, 145, 145, 145, 145, 145, 145, 146],
        [144, 145, 145, 145, 145, 145, 145, 145, 145, 146],
        [144, 145, 145, 145, 145, 145, 145, 145, 145, 146],
        [144, 145, 145, 145, 145, 145, 376, 145, 145, 146],
        [168, 169, 169, 169, 169, 169, 169, 169, 169, 170]
    ],
    "anim": {

        "376": [376, 15, 377, 15, 378, 15, 379, 15]
    }
}
